#hammer
alias update='sudo pacman -Syu'
alias search='pacman -Ss'
alias ysearch='yaourt -Ss'
alias installed='pacman -Qs | less'
alias info='pacman -Si'
alias install='sudo pacman -S'
alias yinstall='sudo yaourt -S'
alias purge='sudo pacman -Rsn'
alias orphan='pacman -Qdt'

#smooth sailing
alias log='cd /var/log; ls'
alias sources='sudo vi /etc/pacman.d/mirrorlist'
alias version='lsb_release -a; uname -a'
alias id='sudo blkid'
alias d='date'
alias h='history'
alias ..='cd ..'
alias c='clear'
alias e='exit'
alias ls='ls --color=auto'

#whip
alias locate='sudo updatedb; locate'
alias check='sudo md5sum'
alias delete='sudo rm -rf'
alias kill='sudo killall'

#extract
alias tar='sudo tar -xvf'
alias targz='sudo tar -zxvf'
alias tgz='sudo tar -zxvf'
alias tarxz='sudo tar -xJf'
alias tarbz2='sudo tar -jxvf'
alias tarbz='sudo tar -jxvf'
alias tbz='sudo tar -jxvf'
alias gz='sudo gzip -d'
alias rar='sudo unrar e'
alias zip='unzip'

#format
alias disk='sudo fdisk -l'
alias usbsdb='sudo umount /dev/sdb; sudo mkfs.vfat -n "pendrive" -I /dev/sdb'
alias usbsdb1='sudo umount /dev/sdb1; sudo mkfs.vfat -n "pendrive" -I /dev/sdb1'
alias usbsdb2='sudo umount /dev/sdb2; sudo mkfs.vfat -n "pendrive" -I /dev/sdb2'
alias usbsdb3='sudo umount /dev/sdb3; sudo mkfs.vfat -n "pendrive" -I /dev/sdb3'
alias usbsdc='sudo umount /dev/sdc; sudo mkfs.vfat -n "pendrive" -I /dev/sdc'
alias usbsdc1='sudo umount /dev/sdc1; sudo mkfs.vfat -n "pendrive" -I /dev/sdc1'
alias usbsdc2='sudo umount /dev/sdc2; sudo mkfs.vfat -n "pendrive" -I /dev/sdc2'
alias usbsdc3='sudo umount /dev/sdc3; sudo mkfs.vfat -n "pendrive" -I /dev/sdc3'

#circle of life
alias gdm='sudo /etc/init.d/gdm3 restart'
alias ldm='sudo /etc/init.d/lightdm restart'
